{
  "name": "maze_hard_15x15",
  "legend": { "0": "free", "1": "wall" },
  "grid": [
    [0,0,0,0,0,1,0,0,0,0,0,1,0,0,0],
    [0,1,1,1,0,1,0,1,1,1,0,1,0,1,0],
    [0,0,0,1,0,0,0,1,0,0,0,0,0,1,0],
    [0,1,0,1,1,1,0,1,0,1,1,1,0,1,0],
    [0,1,0,0,0,1,0,0,0,1,0,0,0,0,0],
    [0,1,1,1,0,1,1,1,0,1,0,1,1,1,0],
    [0,0,0,1,0,0,0,1,0,0,0,1,0,0,0],
    [1,1,0,1,1,1,0,1,1,1,0,1,0,1,1],
    [0,0,0,0,0,0,0,0,0,1,0,0,0,0,0],
    [0,1,1,1,1,1,1,1,0,1,1,1,1,1,0],
    [0,1,0,0,0,0,0,1,0,0,0,0,0,1,0],
    [0,1,0,1,1,1,0,1,1,1,1,1,0,1,0],
    [0,0,0,1,0,0,0,0,0,0,0,1,0,0,0],
    [0,1,1,1,0,1,1,1,1,1,0,1,1,1,0],
    [0,0,0,0,0,1,0,0,0,0,0,1,0,0,0]
  ],
  "start": [0, 0],
  "goal": [14, 14],
  "max_steps": 900
}
